WWWWWWWWWWWW
W..P.......W
W..........W
W.....G....W
WWWWWWWWWWWW