W........bb..W
W.bbb........W
W........bbb.W
W..bb........W
W............W
W.P......B..dW
WWWWWWWWWWWWWW