WWWWWWWWWWWWWW
W..........C.W
W...C........W
W............W
WC...........W
WP...wwww..L.W
WWWWWWWWWWWWWW