WWWWWWWWWWWWWW
W............W
W............W
W............W
W............W
W...........PW
WWWWWWWWWWWWWW