WWWWWWWWWWWW
W..........W
W....WWWWWWW
W.....O....W
WWWWWWWWWWWW