WWWWWWWWWWWWWW
W............W
W............W
W.P.........dW
W.H.H.H.H.H.HW
W.....a......W
WWWWWWWWWWWWWW