WWWWWWWWWWWWWW
W............W
W............W
W............W
W............W
W.R..T..T.T.PW
WWWWWWWWWWWWWW